1111111111
10P0000111
1000CC0011
1000CC0E11
1111111111
