1111111111111111
1E0000C0000000P1
1111111111111111
