111111111
10P000011
1000CC001
1000CC0E1
111111111
