1111111111111111
1010111111111011
1111000E00000111
11110000000P00C1
1111000000000111
1010111111111011
1111111111111111
