11111111111111
1P001000000111
100000C001E111
11111111111111
11111111111111
11111111111111