111111111
1P0000011
1000CC001
1000C0E11
111111111