11111111111111
1P001000000111
100000C0011111
11111111111111