11111111111111111111
1PCCCCCE1C000000C001
10111110111111010101
100000C0000000000001
10000000000C00000001
11111111111111111111
10101010111111111111
11111111111111111111
